1111111111111
1CCC0000000C1
1CPC011111001
1CCC011E00001
1111111111111
