111111
1P0C01
1E0001
111111
111111
