111111
1P0C01
1E0001
100001
111111
