1111111111111111111111111111111111111111
1P000000000C00000001000000C000000000C001
10111111111111110001111111111111111110001
10000000C00000000C0100000000C0000000C001
11111111111111111101111111111111111111001
10C00000000000000001000000000C00000000001
10111111111111111111111111111111111111101
10000000C000C0000001000C00000000C00000001
11111111111111110001111111111111111110001
10000000000000000C01000000000000000000001
10111111111111111101111111111111111111001
1000000C00000C000001000C0000000000C000001
11111111111111110001111111111111111110001
1000000000C000000C01000000C00000000000001
10111111111111111101111111111111111111001
100C00000000C0000E01000000000C000000C0001
10111111111111111101111111111111111110001
1C000000C0000000C001000C000000000C000001
10000000000000000001000000000000000000001
1111111111111111111111111111111111111111